                                                                                                                                                                                                        
                                                                                                                                                                                                        
                                                                                                                                                                                                        
                                                                                                                                                                                                        
                                                                                                                                                                                                        
                                                                                                                                                                                                        
                                                                                                                                                                                                        
                                                                                                                                                                                                        
            ...................................................                ......          .                         .....     ........................................                             
        .....,,,,,.,..,,,,...,,,...,,,,,,,,,,,,,,,,,,,,,,,,,...................................................................................,,,,,,,,,,,,,,,,,,,,,,,,,,,                              
      ...,,,,,***,.                   ,,,,,,,,,***********,,,,,,...............,,,,,,,,,,,,,,,,,,,,,.,,,.,,...,,,,,,,,,,,,,,,,,,,,,,,,,,,,,,,,,,,,******************,,.                                 
    ...,,,*****,                         .,,*********//********,.               .,,,,,,,,,,,,,,,....                    .,,,,,,,,,,,,,,,,,,,,,,,,,*///////////***,..                .                   
   ...,,,***,  ..............................,//////////////*,...................................................................,,,.................,,......................................           
   ...,,*,   ..................................,*/(((((((/,..................................................................................................................................           
   ...,,,,.  .........................,,.,...................................................................................................................................................           
   ...,,,.   ............,*****/////*//*//****,...............,**************,........**,.............,,,,,,,,,,,,..,,,,,,,,,,,,,........,******,.....,.,****,.................,,,,,.........           
   ...,,,.   ............*///////////////////******........***//*********************,,,***.........,.,.,,,,,,,,,,,,,,,,,,,,*,,,,,,...,****///**,,***,****,*****,....,.........,.,,.,........           
   ...,,,    ...........,*////*********/(//(//////*****,,,*///////********************,,**..........,,,,,,,,,,,,,,*,*******************///////**/*,*,**,,..,,,,*,,,,,........................           
   ...,,,,. ...........******,,,,,***//////////(/(((((/***//((/(///**********//////**,,..........,,,,,,,,.,.************////////////////**/*///*,,,*/*,,......,,,,,,,,,,,,,,.,*,..,,.........           
   ...,,,,. ...........**//**,,,,***/*//**/////((((/#(((((/////////**********/////**.........,,,,,,,,,,.......*,*******//((/,,*,//((/**,,,////////////*,,.........,,,,,,,*,,,,,,*..,,........           
   ...,,,,  ...........*****,,,..,,**///***/(/////(#(##(#((//////***,****************,....,,,,,,,*,,,,,...,.,,,*******////**,,,,,,,,*,*///*(*/,***((///*,,....,.....,.,,,,,,,,,*,..,*,.......           
   ...,,,**, ..........*******...,,,,*,,,//*/*///(((#((##((////*/***************,**,*,*,*,,,,***********,,***,********////,,,,///*,,///*#(,*(#/(#/*,/((/****,,,......,,,,,,,,*,,..,,.........           
   ...,,,***,..........,******,....,.,,***/((((((/(/(/(((((/(/******,********,,,,..,****/******,,,,,.,..,,,,,,,,,,*****////,*,*/**,,(*/*,*/#(#((#(/(**(//****,,,,..,...,,,,*.,.,,............           
   ...,,****/,...........*****,,..,.,,,**/////((//*///*//////****/******,*,**,,..,,,*,****//**,,.....,......,,..,.,,,**////(,,//*//,/(((/(#*(#,/(/#/,*///***,,........,.,,,,.................           
   ...,,****//..........,,,,,,.,,.,,,*******///**,,*/,//********************,,..,,,,,,,******,,,.,.................,,**/////,//**//,/(,,,*((/(#((#(**(///**,,,,,,,,,,,.,,.,.....,,...........           
   ...,,,***/**..........,,,.,,,.,,,.,,,*,******,,,****/******//*********,....,,,,,,,,,*****,,,,,,,,.....,...,....,.,****//(****//((((((,(/**//,,,*#//**/,,,.,.,,,,........,.,,.,..,.........           
   ...,,,*****//*.............,,,,,,,,,,,,,,,**,,,,*,*/////*//**/*****,.......,,,,,,,,,,,,,,,,,,,,,,.............,,,,***////*/////((////((/**/////////**,,.,,,,,,,,,,,....,..,.,,,,,.........           
   ...,,,****///(/,......,,,,,*,**,,,.......,,,,,,***,,////*/****,.........,,,,,,,.,,,,,,,,,,,,,,,,..,.....,,,...,.,*****///*,*///////(////*/////////**,*,,,,,,,,,,,,,,,,.,.......,..........           
   ...,,,,***//(((((*.......,,,,,**,,,.,,....,*,,,***********,*,......,,,,,,,,,,,,,,,,,,,,,,,**,,,,,.,.........,.,,.,,*******/,*////*///*,/*,,**,,*********,,,,.,,,,,,,,,,,,..,....,.........           
   ...,,,***//(((((((*,.......,,,,,*,,,.,...,,,,,*,*,,,*****,......,,,,,,,,,.,,,,,,,,,,,,,,,,,*,,,,,,,,,,,,,,,,,,,,,,,,*****/*,*,***/*////*,*,,,,*,*********,,,.,..,,,,,,,,,.,,,.............           
   ...,,,**///((##(((((*.........,,,,,,,,,,,,,,,***,..........,****,,,,,*,,,,,,,,,,,,,,,,,,,,,,,,,,,,,,,,,,,,,,,,,,,...,,***///*,,,,*/***,,,,,,,,,,,******,*/*,,.,,,,,,,,.,**,,..............           
   ...,,***///((#######(*........,,******,,,,,,,*,,..,,,,,,,,,**,**,****,,,,,,,,,,,,,,,..,,...,.,,,.....,,,,..,,,,,,..,,,,,,*******,,**,,,,,,,,,,,,,,*/******/,,,,,,,*,,.****,,...,,.........           
   ...,,***///((#####(#(........,,,,,,,,,,,,,,,*,....,,,,,,*,,,,*********,,*,,,,,,,,,,,,,.,,,,,,.,,,,,,,,,,..........,.,,.,*,,,,,**,,,,,,,,,,*,,,,,,,,,**********,,,,**,,***,,,..............           
   ...,,***///((###((((,.........,,,,,******,*,,....,,,***,,,,,,,,,,,,**,,,*,,,,,,,,,,...,,,..,..,,.,,....,..,.......,.,.....,,,,,,,,,,,,,,,,,,,*,,,**/*/((///**,,,*,********,,.,*,..........           
   ...,,***///((((##((/,.........,,,,,,,*,,,,,.....,,**,***,,,,,,,,,,,,,,,,,,,,,,,,,,...,.,,.,.,,.,,.,....,,...,,,,,..,,.........,,,,,,,,,,,,,,,,,,,**///////*,//*,,,,********,..............           
   ..,,,***///((((((((,.........,,,,,*,,,,**,.....,,,******,.,,,,,,,,,,.,,,,,,,,,.,,....,.,,,,,......,,,,,....,...,,,...,,,,,.......,........,,,****///**/*,,,(/(/////(****,***..,...........           
   ...,,****//((((((/..........,,,,,**,,**,*,,,...,*,***,,,,,,,,,,*,,,,,,,,,..,,,.,..,.,......,,,,,..,,.,.,.......,,.,.....,,..,..,...........,,**//*****,,,,,,*,*,(((/**,*****.,*...........           
   ...,,,**////(//*...........,,,,,**,*****,,.....,***,.,,,,,,,,,,,,*,,,.,,,,,,..,...........*,.,.,,,.,..,,,..,....,,,,,,,..,,,,,........,,,,,,,,,*//**,,,,,,,,,**/(////////*................           
   ...,,,***/**................,,,,,,,,**......,,,,**,,,,,,,,,,,..,,,*,,,,,,,,,..,...,......,..,,,,,...,........,...,..,,,....,,.,,,....,...,.,,,,,,,**,,,,,***,...,,***//*,.................           
   ...,,,*,  ...............................,,,,,,,,,,,,,,,,****,,,,,,,,,,,,,.,,,,.......,...,....,,,......,,....,...,,,......*,...,.,....,,....,,,,,,,,,,,,*,......*****/*..................           
   ...,.    . ...............,,,...,.....,.,,,,***,,,****,,,.,,,,.,,,,,*,,,.,.....,.,,,..............,...,......,..,*.....,,**,,*..,,,,...,..,,,,,,,,,,,,,*****..,********,,.................           
   ..       ..,*****////(/***********,,,.,.,,,,,,,,.,***,,,,,,,**,,,,,,,...,,,,...,..,,............,..,..........,.,,....,,,.,,*,...,,..,,,,,,...,.,,***,,,,,.,.*****,,,,....................           
   .        .,,***(/%#####(***/((///**,,,,,,,,,,,,,,,,,,,,,.**/****,*,,,,,,.,,..................,...............,........,,.,...,,,,,,,*,,,,,,,..,,,,**,,.,...,*,*,,.........................           
   .       ..,,,*//##%%###((/((((((((//**,,**,,,,,,,,,,,.,,****,****,,,,,,,...,..,,..,.......,...........,........,......,,*,,,.,,,,,.,,,,,,,.,,.,,.,,,,,..............,.....,,,.............           
           .,,*//###%%##(#((/#%(##(##//***///***,,.,..,*,,,.*,*,,,,,,,,,,,,,.,...,,,...,,,..............*..,,,,...,...,,..,,,,.,,,,.,,,****,,,,,,,,,,,....................,...,..............           
           ..,//#%%%%##((((/#%%%#%%#((/##(////***,,.,.,,,**.,,,,,,,,,,,,*,.,,,.......,......,.......,....,....,...,..,.,..,,,,,.,,,,***,,,,,,*,,,,,,,,,,,............,......,................           
          .,*/*#%%%%(#(((((((##%%%%%%#((/###(/*/*/**,,,..,,,,,..,,,,,,,,,.,,.....,...,..,..,...........,.....,..,,,,...,,,,,,,,,,,,,...****,.,**********,,,..,.,,,,*****,......,.............           
          ..,*(#%%%###(#(((((((####(#(((((((((//###/(**,,,,,,.,.,...,,,,.,....,..,,,.,..............,........,,..,.,..,,,,,,,,,*,,,,,,*******,,,,,,***,****,.,,,****/***,*,,.................           
          .,*/(###/##((((#(//(/(((/(((((((((/((((/###//*****,,,,,..,,..,.,,...,.....,.....,,,,,,..,....,..,..,,......,,,.,,,,,,,,,**,,,,,***,,*,.,..*****,,,*****///(///****,................           
       .,,,**((##///(((/((((//(((((((/////(////((//#(((((//******,,,.,,,,,,,,,.,,,,.,.,....,......,.....,,...........,,.,,,.,,,,,,,,,,,*,.,,,***,,********,,,,.,***//////**,,................           
     ...,,,**(((((//*(/////*******////(((((((/(((#(#((/(#(//*//****,,..,,......,,,,,,,,,.,.,............,,,,,..........,,,**,,,.,,,,..,....,,..,*,******,,***,,,,***/*//***,,,...............           
     ...,,*****/***********,,,****/*////*////*/(#(/((//((///**,,,,,,*,.,.,.,,,,.,.,....,.,,.,.,,,.,....,,..,..,......,.,,,,,**,.,*..,,*,..,,,,.,..,,.,,..,,,*****///////**,,,..,.............           
    ....,,,,,,**,,,,,,..,,,,,,******/*..,*///*,,**///////**,,,,,,,,,,,...,,.,,,,,,,,...,,,,,......,.,.,............,,,,**////*,,.,...........,,,,,.,,...,,,,,***************,,...,...........           
      ......,,,,,,........,,,.,,,,,***,,,*,*,,,.,*,*****,*,,,***,,,,,,.,,..,,,,,,,,,,,,,,,,.........,...,,*,..........,*///*,,,...........,.,.,,.,,.,.,.,,,,,,,,,,.,,********,,,.,...........           
          .........................,,,*,,,,......,,,,,,,,,*******,...,...,..,****,,,,,,,.,...........,.....,,.,,,,,,,,,******,,..,.......,,,.,..,,..,,..*.,,,,,,****,.,,,,,,,*,,.............           
          ..........................,..,,..........,,,,,.,*******,..........,******,,...,..,,,,,..,,,,......,..,,,,,,,,****.,,,.....,.,,,,,...,.*,,..,..,,.,,,,,,,,,.,........,,.............           
          ..................,,,.....................,,,,,,**/*/**,,,,......,,,,,,,........,,,,,,,,,,,,,,.....,,,,.....,,,,,,,,*,*,,....,,,*,,,*,,,,.,,,,,,****,...,...,.,.,..,..,............           
          ....................................,.......,,,,***/*////**,,..,,,,,.,.,,,,,,,...,,...,,,,,,,,,,..,,,,.......,,,,,,**,***,,*****,..,.,,,**,,.,,,****,...............,,,............           
          .............................,..................,,,***///*,,,,,,,,,,...,,,,,,,,,..,,,,,,,....,,,,..,,.........,,,.,,,**,*//***,,******,,,,*,,,,.,..................................           
          ...........................,.....................,,*******,,*,,**,**,,,.,,,,,,,,...,,,..............,........,,,,.,,,,*,,*//*,,,,,,****,***,,,,,...................................           
          ..............................................,,,,,,,,,************/***,,,,,,,,,,,....,,,................,....,,,,**,,,.,,,*****,*,*,,,,,,,,.,,,,............,.....................           
          ................................................,...,,,,,,,,,,,,*///**,,,,,,,,,,,,,..............,...,,....,......,.,,..,,,,,,,,,,,,,,,,,,,,,,,,,,,,...............................           
          .......................................................,,,,,,.,,*/((//*,,,,,,,,,,,........,,,.,,..,.........,..,,..,.,.,,..,,,...,.,...,,...,***,,,,,***...........................           
          .......................................................,,,,...,,,//(//****,,,,,,,,,....,.......,,,,..,,...,.....,....,,.,.......,.,,,,,...,.......,.................,..,,..........           
          .......................................................,,,,,,,,**//(//*****,,,,,,,..........,,,,,,,,..,,,,,,,...........,..,,....,,,,,,,.................,.........,,....,,........           
          .......................................................,,,,,,*,***//***,,,,.,,.,,,,,,......,..,,,,,,.,,,,,.,....,...,,,.,,,....,,..,,,,,.....,,,....,,,,.,........,,....,,,........           
          ........................................................,,,,,,,*********,,,,.,,,,,..........,,.,,,........,............,,...............,,..........,.................,,,..........           
          .......................................................,*****////////////****,,,,,,,...............................................................................................           
           ......................................................,,,,************,,,,,.,....................................................................................................            
             ......................................................,,,,,,,,,,,,,,,,,.. ..                                                                                                               
                                                                   ...............                                                                                                                      
                                                                      .... .                                                                                                                            
                                                                                                                                                                                                        
                                                                                                                                                                                                        
                                                                                                                                                                                                        
                                                                                                                                                                                                        
                                                                                                                                                                                                        
                                                                                                                                                                                                        
                                                                                                                                                                                                        
                                                                                                                                                                                                        
